NO ./path_to_the_north_texture
SO ./path_to_the_south_texture
WE ./path_to_the_west_texture
EA ./path_to_the_east_texture

F 220,100,0
C 225,30,0

        1111111111111111111111111
        1000000000110000000000001
        1011000001110000000000001
        1001000000000000000000001
111111111011000001110000000000001
100000000011000001110111111111111
11110111111111011100000010001
11110111111111011101010010001
11000000110101011100000010001
11111111111110000011111111111
            1000001
            1000001
1111111111111000001111111111111
100000000000000011000000100011
100000000000000011010101N01001
110000011101010111110111100001
11110111 1110101 1011110100011
11111111 1111111 1111111111111
