1111111111
1000000001
1111110001
1000P00001
1000000001
1000000001
1001111111
1000000001
1000000001
1111111111